111111111111111111111111111111
100010001000100010000000001000
101111101011111010111110111010
001000101000000010101000100001
101011101110101111101110101110
100000001000100010001000000000
101110111011111010111010111110
100010000010001000000010001000
111111111110101011111110101110
100010100010100010000010100010
111010111010101110101110111111
000010000000100000100010000010
101011111011111011101111101110
101000000000001000100000100000
111111111111111111111111111111