111111111111111111111111111111
100010000000100010101000100001
101110111010111010101010101110
000010100010100000100010001000
111010101111101010101010111011
101000100000001010101010000010
101011111110111010111011101110
100010100010100010001000100000
111110101011101110101110101010
100010101000100000100000001010
101010101010101111111110101011
001010001010001000100000101001
101010111010111010101111101011
101000100010000010000000100000
111111111111111111111111111111