111111111111111111111111111111
100000000000001000100010001000
100000000000001010101110101011
100011000110000010000000101000
100011000110001111111010111011
100000000000000000100010000000
100000000000001110111111111011
100000000000000010101000001010
100000000000001011101011111110
100000000000001000001000100000
100011000110001111101110101011
100011000110001010001000001000
100000000000001010111010111111
100000000000000010000010000000
111111111111111111111111111111
