111111111111111111111111111111
100000001000100000001000100000
101011101011101111101011101011
001010000000100010000010001000
111010111110111011111110111111
100010100010100000100000001000
111111101110111110101111111011
100010001010000010100000100010
101011101010111010111011101010
101000100000100000001000001010
101111101111101111111010111010
000000001000100000000010001000
111011111010111011111011101011
100000000001000000100010001000
111111111111111111111111111111