111111111111111111111111111111
100010000000001000100010001000
101110111011101010101110101011
000010001000100010000000101000
111011101110101111111010111011
100000101000100000100010000000
101110100011111110111111111011
111010001000100010101000001010
101011111111101011101011111110
100010100000101000001000100000
101010101110101111101110101011
001010001010001010001000001000
111010101010111010111010111111
100000100010000010000010000000
111111111111111111111111111111
